15
1  1  1  1  1  1  1  1  1  1  1  1  1  1  1
1  1  1  1  1 -1  0  0  1  1  1  1  1  1  1
1  1  1  1  1  1  0  0  0  1  1  1  1  1  1
1  1  1  1  1  0  0  0  0  0  1  1  1  1  1
1  1  1  1  1  0  0  0  0  0  1  1  1  1  1
1  1  1  1 -2  0  0  0  0  0 -2  1  1  1  1
1  1  1  0  1  1  1  0  1  1  1  0  1  1  1
1  1  1  0  1  0  1  0  1  0  1  0  1  1  1
1  1  1  0  1  0  1  0  1  0  1  0  1  1  1
1  1  0  0  1  1  1  0  1  1  1  0  0  1  1
1  1 -2  0  0  0  0  0  0  0  0  0 -2  1  1
1  0  0  0 -2  1  1  1  1  1 -2  0  0  0  1
1 -2  0  0  0  0  1  1  1  0  0  0  0 -2  1
1  1  0  0  0  0  0  2  0  0  0  0  0  1  1
1  1  1  1  1  1  1  1  1  1  1  1  1  1  1
8
5 4
5 10
10 2
10 12
11 4
11 10
12 1
12 13
