21
1  1  1  1  1  1  1  1  1  1  1  1  1  1  1  1  1  1  1  1  1
1  1  1  1  1  1  1  1  1  1 -1  1  1  1  1  1  1  1  1  1  1
1  1  1  1  1  1  1  1  1  0  0  0  1  1  1  1  1  1  1  1  1
1  1  1  1  1  1  1  1 -2  0  0  0 -2  1  1  1  1  1  1  1  1
1  1  1  1  1  1  1 -2  0  0  0  0  0 -2  1  1  1  1  1  1  1
1  1  1  1  1  1 -2  0  0  0  0  0  0  0 -2  1  1  1  1  1  1
1  1  1  1  1 -2  0  0  0  0  0  0  0  0  0 -2  1  1  1  1  1
1  1  1  1 -2  0  0  0  0  0  0  0  0  0  0  0 -2  1  1  1  1
1  1  1 -2  0  0  0  0  0  0  0  0  0  0  0  0  0 -2  1  1  1
1  1 -2  0  0  0  0  0  0  0  0  0  0  0  0  0  0  0 -2  1  1
1 -2  0  0  0  0  0  0  0  0  0  0  0  0  0  0  0  0  0 -2  1
1  1 -2  0  0  0  0  0  0  0  0  0  0  0  0  0  0  0 -2  1  1
1  1  1 -2  0  0  0  0  0  0  0  0  0  0  0  0  0 -2  1  1  1
1  1  1  1 -2  0  0  0  0  0  0  0  0  0  0  0 -2  1  1  1  1
1  1  1  1  1 -2  0  0  0  0  0  0  0  0  0 -2  1  1  1  1  1
1  1  1  1  1  1  0  0  0  0  0  0  0  0  0  1  1  1  1  1  1
1  1  1  1  1  1  1  0  0  0  0  0  0  0  1  1  1  1  1  1  1
1  1  1  1  1  1  1  1  0  0  0  0  0  1  1  1  1  1  1  1  1
1  1  1  1  1  1  1  1  1  0  0  0  1  1  1  1  1  1  1  1  1
1  1  1  1  1  1  1  1  1  1  2  1  1  1  1  1  1  1  1  1  1
1  1  1  1  1  1  1  1  1  1  1  1  1  1  1  1  1  1  1  1  1
24
3 8
3 12
4 7
4 13
5 6
5 14
6 5
6 15
7 4
7 16
8 3
8 17
9 2
9 18
10 1
10 19
14 5
14 15
13 4
13 16
12 3
12 17
11 2
11 18
